NO ./path_to_NO
SO     ./path_to_SO
WE      ./path_to_WE  
EA ./path_to_EA

F 4, 15 ,94
C 0, 2 , 3

  1
 11111111
 111
  1
