NO ./path_to_NO
WE ./path_to_WE
EA ./path_to_EA
SO ./path_to_SO   

F 15,100
C 225,30,0

11111111111111111
10000001010000101
11000011000001001
11111111111111111
