NO ./path_to_NO
SO     ./path_to_SO
WE      ./path_to_WE  
EA ./path_to_EA

F 4, 15 ,94
C 0, 2 , 3

111
11
                  11
         111111 111111 11111111111
        1000000100110010000000001
      11100000111000000000000111
       111001000000000000000000011
      1001000000000000000000001111
       1110010000000000000000000001
         1001000000000000000000001
         1001000000000000000000001
111111111011000001110000000000001
100000000011000001110111111111111
11110111111111011100000010001
11110111111111011101010010001
11000000110101011100000010001
1000000000000000110000001001
10000000000000001101010010001
11000001110101011111011110N0111
11110111 1110101 10111101001
11111111 1111111 111111111111
