
NO ./path_to_NO


SO        ./path_to_SO
WE      ./path_to_WE 
EA ./path_to_EA

  F 145    ,02 ,     3

C   4 ,250     , 254

111
111
111
1N1
11111111
