WE      ./path_to_WE  
EA ./path_to_EA
SO     ./path_to_SO
NO ./path_to_NO

F 255, 254 ,254
F 255, 254 ,254

11111111111111111
10000001010000101
11000011000001001
11111111111111111
