NO ./path_to_NO
SO     ./path_to_SO
WE      ./path_to_WE  
EA ./path_to_EA

F 4, 15 ,94
C 0, 2 , 3
1111111111111111111111
1000000101NSEW0000101
11000011000001001
11111111111111111

