NO ./textures/NO.xpm
SO ./textures/SO.xpm
WE ./textures/WE.xpm
EA ./textures/EA.xpm

F 220,100,0
C 225,30,0

1111111111
1000001001
1110000001
11000N1111
1111111111
